02000000000000000000000000000000000001
00000000000000000001110000000000000000
00000000000000000011111000000000000000
00000111000000000011111000000000000000
00000111000000000001110000000000000000
00000111000010000000000000000000000000
00001110000000000000011100000000000000
00000000000000000000000000001111000000
00000000011110000000000000000000000000
00000000010000000000000000011100011000
00000000010000000000000000000000000000
00000011110000000011110000000000000100
00000000010000000111110000000000000000
00000000010000011111110000000000000000
00000000000000001111100000000001000000
00000000000000000011000000000011100000
00000001111111111000000000000111000000
00000001111111111000000000000011100000
00000001111111111000000000000000000000
00000000000000000000000000000000000000